................
................
.....##..##.###.
....#..#....#..#
..#............#
#...##..#...##..
#.#.#..##.#.#..#
#####.#######.##