#..........................#
#..........................#
#..........................#
#..........................#
#..........................#
#..........................#
#..........................#
####.....####..............#
####.....####..............#
####.....####..............#
####.....###########.......#
####.....###########.......#
####.....####..............#
####...######..............#
####...######.....##########
####.....####.....##########
####.....####..............#
####.....####..............#
####.....######............#
####.....######............#
####.....#########...###...#
####.....#########...###...#
#######..####..............#
#######..####..............#
####....................####
#..........................#
#..........................#
#....#######....#######....#
#..........................#
#..........................#
#..........................#
#..###....###..###....###..#
#..........................#
#..........................#
#..........................#
#....#######....#######....#
............................
............................
############################