#....#######....#######....#
#....#######........z......#
#.+..#######..............w#
#....##########............#
#....##########............#
#....##########............#
#.................###......#
#.................###......#
#.......1.........###......#
#....s1...1.......###$.....#
#....#######....#######....#