#....#######....#######....#
#.....c....2....2....C.....#
#........s.................#
#........##########........#
#W.......##########.......w#
#.....1...1.....S1..s1.....#
#....#######....#######....#