#....#######....#######....#
#................Z.........#
#..........s...............#
####....####........s...####
######..####....######..####
######..####....######..####
####....##z.......##.z..####
####11..##1......1##11..####
####....##1.####.1##...$####
####..####1.####.1##..######
####....##1......1##....####
####11..##1......1##11..####
######..####....######..####
######..####....######..####
####....................####
#......s..........s........#
#....#######....#######....#