#..........................#
#+.........................#
#w.........#################
#.....######################
#.....######################
#.......C.............z....#
###..............@.........#
###.1.1......11......1.1.1.#
###..s...................s$#
########....####....########
########....####....########
#.........................W#
#.....1s..1......1..S1.....#
#....#######....#######....#