#....#######....#######....#
#.....z..........@.........#
#.........S1...1s.....1.1..#
#.........#######...########
#.........#######...########
#W.........................#
#.....1...1......1...1s....#
#....#######....#######....#