#.......c..................#
#..........................#
#...2......2....2......2..W#
#..###....###..###....###..#
#...C......................#
#.....1...1...@..1...1.....#
#....S..........S.....s....#
#....#######....#######....#