#....#######....#######....#
#..................c.......#
#..........................#
#....2........#............#
#....2.............@......W#
#...###....2...............#
#...###....s...............#
#.....+...###..............#
#.........###....S.........#
#...............###........#
#...............###...2....#
#....................S.....#
#....................##...$#
#......s.........1.1.##...##
#....#######....#######....#