#.......C..........c.......#
#............11............#
#..........................#
#....1.s..1.####S1....1....#
#...####################...#
#1..####################..1#
#.............c............#
#1........................1#
##......1..........1......##
#......###........###......#
#....1.###.1....1.###.1....#
#....#######....#######....#